Month,Starting Balance,Repayment,Interest Paid,Principal Paid,New Balance,Mortgage Name
1,400000.0,1686.42,1000.0,686.42,399313.58,30 Year
2,399313.58,1686.42,998.28,688.14,398625.44,30 Year
3,398625.44,1686.42,996.56,689.86,397935.58,30 Year
4,397935.58,1686.42,994.83,691.59,397243.99,30 Year
5,397243.99,1686.42,993.1,693.32,396550.67,30 Year
6,396550.67,1686.42,991.37,695.05,395855.62,30 Year
7,395855.62,1686.42,989.63,696.79,395158.83,30 Year
8,395158.83,1686.42,987.89,698.53,394460.3,30 Year
9,394460.3,1686.42,986.15,700.27,393760.03,30 Year
10,393760.03,1686.42,984.4,702.02,393058.01,30 Year
11,393058.01,1686.42,982.64,703.78,392354.23,30 Year
12,392354.23,1686.42,980.88,705.54,391648.69,30 Year
13,391648.69,1686.42,979.12,707.3,390941.39,30 Year
14,390941.39,1686.42,977.35,709.07,390232.32,30 Year
15,390232.32,1686.42,975.58,710.84,389521.48,30 Year
16,389521.48,1686.42,973.8,712.62,388808.86,30 Year
17,388808.86,1686.42,972.02,714.4,388094.46,30 Year
18,388094.46,1686.42,970.23,716.19,387378.27,30 Year
19,387378.27,1686.42,968.44,717.98,386660.29,30 Year
20,386660.29,1686.42,966.65,719.77,385940.52,30 Year
21,385940.52,1686.42,964.85,721.57,385218.95,30 Year
22,385218.95,1686.42,963.04,723.38,384495.57,30 Year
23,384495.57,1686.42,961.23,725.19,383770.38,30 Year
24,383770.38,1686.42,959.42,727.0,383043.38,30 Year
25,383043.38,1686.42,957.6,728.82,382314.56,30 Year
26,382314.56,1686.42,955.78,730.64,381583.92,30 Year
27,381583.92,1686.42,953.95,732.47,380851.45,30 Year
28,380851.45,1686.42,952.12,734.3,380117.15,30 Year
29,380117.15,1686.42,950.29,736.13,379381.02,30 Year
30,379381.02,1686.42,948.45,737.97,378643.05,30 Year
31,378643.05,1686.42,946.6,739.82,377903.23,30 Year
32,377903.23,1686.42,944.75,741.67,377161.56,30 Year
33,377161.56,1686.42,942.9,743.52,376418.04,30 Year
34,376418.04,1686.42,941.04,745.38,375672.66,30 Year
35,375672.66,1686.42,939.18,747.24,374925.42,30 Year
36,374925.42,1686.42,937.31,749.11,374176.31,30 Year
37,374176.31,1686.42,935.44,750.98,373425.33,30 Year
38,373425.33,1686.42,933.56,752.86,372672.47,30 Year
39,372672.47,1686.42,931.68,754.74,371917.73,30 Year
40,371917.73,1686.42,929.79,756.63,371161.1,30 Year
41,371161.1,1686.42,927.9,758.52,370402.58,30 Year
42,370402.58,1686.42,926.0,760.42,369642.16,30 Year
43,369642.16,1686.42,924.1,762.32,368879.84,30 Year
44,368879.84,1686.42,922.19,764.23,368115.61,30 Year
45,368115.61,1686.42,920.28,766.14,367349.47,30 Year
46,367349.47,1686.42,918.37,768.05,366581.42,30 Year
47,366581.42,1686.42,916.45,769.97,365811.45,30 Year
48,365811.45,1686.42,914.52,771.9,365039.55,30 Year
49,365039.55,1686.42,912.59,773.83,364265.72,30 Year
50,364265.72,1686.42,910.66,775.76,363489.96,30 Year
51,363489.96,1686.42,908.72,777.7,362712.26,30 Year
52,362712.26,1686.42,906.78,779.64,361932.62,30 Year
53,361932.62,1686.42,904.83,781.59,361151.03,30 Year
54,361151.03,1686.42,902.87,783.55,360367.48,30 Year
55,360367.48,1686.42,900.91,785.51,359581.97,30 Year
56,359581.97,1686.42,898.95,787.47,358794.5,30 Year
57,358794.5,1686.42,896.98,789.44,358005.06,30 Year
58,358005.06,1686.42,895.01,791.41,357213.65,30 Year
59,357213.65,1686.42,893.03,793.39,356420.26,30 Year
60,356420.26,1686.42,891.05,795.37,355624.89,30 Year
61,355624.89,1686.42,889.06,797.36,354827.53,30 Year
62,354827.53,1686.42,887.06,799.36,354028.17,30 Year
63,354028.17,1686.42,885.07,801.35,353226.82,30 Year
64,353226.82,1686.42,883.06,803.36,352423.46,30 Year
65,352423.46,1686.42,881.05,805.37,351618.09,30 Year
66,351618.09,1686.42,879.04,807.38,350810.71,30 Year
67,350810.71,1686.42,877.02,809.4,350001.31,30 Year
68,350001.31,1686.42,875.0,811.42,349189.89,30 Year
69,349189.89,1686.42,872.97,813.45,348376.44,30 Year
70,348376.44,1686.42,870.94,815.48,347560.96,30 Year
71,347560.96,1686.42,868.9,817.52,346743.44,30 Year
72,346743.44,1686.42,866.85,819.57,345923.87,30 Year
73,345923.87,1686.42,864.8,821.62,345102.25,30 Year
74,345102.25,1686.42,862.75,823.67,344278.58,30 Year
75,344278.58,1686.42,860.69,825.73,343452.85,30 Year
76,343452.85,1686.42,858.63,827.79,342625.06,30 Year
77,342625.06,1686.42,856.56,829.86,341795.2,30 Year
78,341795.2,1686.42,854.48,831.94,340963.26,30 Year
79,340963.26,1686.42,852.4,834.02,340129.24,30 Year
80,340129.24,1686.42,850.32,836.1,339293.14,30 Year
81,339293.14,1686.42,848.23,838.19,338454.95,30 Year
82,338454.95,1686.42,846.13,840.29,337614.66,30 Year
83,337614.66,1686.42,844.03,842.39,336772.27,30 Year
84,336772.27,1686.42,841.93,844.49,335927.78,30 Year
85,335927.78,1686.42,839.81,846.61,335081.17,30 Year
86,335081.17,1686.42,837.7,848.72,334232.45,30 Year
87,334232.45,1686.42,835.58,850.84,333381.61,30 Year
88,333381.61,1686.42,833.45,852.97,332528.64,30 Year
89,332528.64,1686.42,831.32,855.1,331673.54,30 Year
90,331673.54,1686.42,829.18,857.24,330816.3,30 Year
91,330816.3,1686.42,827.04,859.38,329956.92,30 Year
92,329956.92,1686.42,824.89,861.53,329095.39,30 Year
93,329095.39,1686.42,822.73,863.69,328231.7,30 Year
94,328231.7,1686.42,820.57,865.85,327365.85,30 Year
95,327365.85,1686.42,818.41,868.01,326497.84,30 Year
96,326497.84,1686.42,816.24,870.18,325627.66,30 Year
97,325627.66,1686.42,814.06,872.36,324755.3,30 Year
98,324755.3,1686.42,811.88,874.54,323880.76,30 Year
99,323880.76,1686.42,809.7,876.72,323004.04,30 Year
100,323004.04,1686.42,807.51,878.91,322125.13,30 Year
101,322125.13,1686.42,805.31,881.11,321244.02,30 Year
102,321244.02,1686.42,803.11,883.31,320360.71,30 Year
103,320360.71,1686.42,800.9,885.52,319475.19,30 Year
104,319475.19,1686.42,798.68,887.74,318587.45,30 Year
105,318587.45,1686.42,796.46,889.96,317697.49,30 Year
106,317697.49,1686.42,794.24,892.18,316805.31,30 Year
107,316805.31,1686.42,792.01,894.41,315910.9,30 Year
108,315910.9,1686.42,789.77,896.65,315014.25,30 Year
109,315014.25,1686.42,787.53,898.89,314115.36,30 Year
110,314115.36,1686.42,785.28,901.14,313214.22,30 Year
111,313214.22,1686.42,783.03,903.39,312310.83,30 Year
112,312310.83,1686.42,780.77,905.65,311405.18,30 Year
113,311405.18,1686.42,778.51,907.91,310497.27,30 Year
114,310497.27,1686.42,776.24,910.18,309587.09,30 Year
115,309587.09,1686.42,773.96,912.46,308674.63,30 Year
116,308674.63,1686.42,771.68,914.74,307759.89,30 Year
117,307759.89,1686.42,769.39,917.03,306842.86,30 Year
118,306842.86,1686.42,767.1,919.32,305923.54,30 Year
119,305923.54,1686.42,764.8,921.62,305001.92,30 Year
120,305001.92,1686.42,762.5,923.92,304078.0,30 Year
121,304078.0,1686.42,760.19,926.23,303151.77,30 Year
122,303151.77,1686.42,757.87,928.55,302223.22,30 Year
123,302223.22,1686.42,755.55,930.87,301292.35,30 Year
124,301292.35,1686.42,753.23,933.19,300359.16,30 Year
125,300359.16,1686.42,750.89,935.53,299423.63,30 Year
126,299423.63,1686.42,748.55,937.87,298485.76,30 Year
127,298485.76,1686.42,746.21,940.21,297545.55,30 Year
128,297545.55,1686.42,743.86,942.56,296602.99,30 Year
129,296602.99,1686.42,741.5,944.92,295658.07,30 Year
130,295658.07,1686.42,739.14,947.28,294710.79,30 Year
131,294710.79,1686.42,736.77,949.65,293761.14,30 Year
132,293761.14,1686.42,734.4,952.02,292809.12,30 Year
133,292809.12,1686.42,732.02,954.4,291854.72,30 Year
134,291854.72,1686.42,729.63,956.79,290897.93,30 Year
135,290897.93,1686.42,727.24,959.18,289938.75,30 Year
136,289938.75,1686.42,724.84,961.58,288977.17,30 Year
137,288977.17,1686.42,722.44,963.98,288013.19,30 Year
138,288013.19,1686.42,720.03,966.39,287046.8,30 Year
139,287046.8,1686.42,717.61,968.81,286077.99,30 Year
140,286077.99,1686.42,715.19,971.23,285106.76,30 Year
141,285106.76,1686.42,712.76,973.66,284133.1,30 Year
142,284133.1,1686.42,710.33,976.09,283157.01,30 Year
143,283157.01,1686.42,707.89,978.53,282178.48,30 Year
144,282178.48,1686.42,705.44,980.98,281197.5,30 Year
145,281197.5,1686.42,702.99,983.43,280214.07,30 Year
146,280214.07,1686.42,700.53,985.89,279228.18,30 Year
147,279228.18,1686.42,698.07,988.35,278239.83,30 Year
148,278239.83,1686.42,695.59,990.83,277249.0,30 Year
149,277249.0,1686.42,693.12,993.3,276255.7,30 Year
150,276255.7,1686.42,690.63,995.79,275259.91,30 Year
151,275259.91,1686.42,688.14,998.28,274261.63,30 Year
152,274261.63,1686.42,685.65,1000.77,273260.86,30 Year
153,273260.86,1686.42,683.15,1003.27,272257.59,30 Year
154,272257.59,1686.42,680.64,1005.78,271251.81,30 Year
155,271251.81,1686.42,678.12,1008.3,270243.51,30 Year
156,270243.51,1686.42,675.6,1010.82,269232.69,30 Year
157,269232.69,1686.42,673.08,1013.34,268219.35,30 Year
158,268219.35,1686.42,670.54,1015.88,267203.47,30 Year
159,267203.47,1686.42,668.0,1018.42,266185.05,30 Year
160,266185.05,1686.42,665.46,1020.96,265164.09,30 Year
161,265164.09,1686.42,662.91,1023.51,264140.58,30 Year
162,264140.58,1686.42,660.35,1026.07,263114.51,30 Year
163,263114.51,1686.42,657.78,1028.64,262085.87,30 Year
164,262085.87,1686.42,655.21,1031.21,261054.66,30 Year
165,261054.66,1686.42,652.63,1033.79,260020.87,30 Year
166,260020.87,1686.42,650.05,1036.37,258984.5,30 Year
167,258984.5,1686.42,647.46,1038.96,257945.54,30 Year
168,257945.54,1686.42,644.86,1041.56,256903.98,30 Year
169,256903.98,1686.42,642.25,1044.17,255859.81,30 Year
170,255859.81,1686.42,639.64,1046.78,254813.03,30 Year
171,254813.03,1686.42,637.03,1049.39,253763.64,30 Year
172,253763.64,1686.42,634.4,1052.02,252711.62,30 Year
173,252711.62,1686.42,631.77,1054.65,251656.97,30 Year
174,251656.97,1686.42,629.14,1057.28,250599.69,30 Year
175,250599.69,1686.42,626.49,1059.93,249539.76,30 Year
176,249539.76,1686.42,623.84,1062.58,248477.18,30 Year
177,248477.18,1686.42,621.19,1065.23,247411.95,30 Year
178,247411.95,1686.42,618.52,1067.9,246344.05,30 Year
179,246344.05,1686.42,615.86,1070.56,245273.49,30 Year
180,245273.49,1686.42,613.18,1073.24,244200.25,30 Year
181,244200.25,1686.42,610.5,1075.92,243124.33,30 Year
182,243124.33,1686.42,607.81,1078.61,242045.72,30 Year
183,242045.72,1686.42,605.11,1081.31,240964.41,30 Year
184,240964.41,1686.42,602.41,1084.01,239880.4,30 Year
185,239880.4,1686.42,599.7,1086.72,238793.68,30 Year
186,238793.68,1686.42,596.98,1089.44,237704.24,30 Year
187,237704.24,1686.42,594.26,1092.16,236612.08,30 Year
188,236612.08,1686.42,591.53,1094.89,235517.19,30 Year
189,235517.19,1686.42,588.79,1097.63,234419.56,30 Year
190,234419.56,1686.42,586.04,1100.38,233319.18,30 Year
191,233319.18,1686.42,583.29,1103.13,232216.05,30 Year
192,232216.05,1686.42,580.54,1105.88,231110.17,30 Year
193,231110.17,1686.42,577.77,1108.65,230001.52,30 Year
194,230001.52,1686.42,575.0,1111.42,228890.1,30 Year
195,228890.1,1686.42,572.22,1114.2,227775.9,30 Year
196,227775.9,1686.42,569.43,1116.99,226658.91,30 Year
197,226658.91,1686.42,566.64,1119.78,225539.13,30 Year
198,225539.13,1686.42,563.84,1122.58,224416.55,30 Year
199,224416.55,1686.42,561.04,1125.38,223291.17,30 Year
200,223291.17,1686.42,558.22,1128.2,222162.97,30 Year
201,222162.97,1686.42,555.4,1131.02,221031.95,30 Year
202,221031.95,1686.42,552.57,1133.85,219898.1,30 Year
203,219898.1,1686.42,549.74,1136.68,218761.42,30 Year
204,218761.42,1686.42,546.9,1139.52,217621.9,30 Year
205,217621.9,1686.42,544.05,1142.37,216479.53,30 Year
206,216479.53,1686.42,541.19,1145.23,215334.3,30 Year
207,215334.3,1686.42,538.33,1148.09,214186.21,30 Year
208,214186.21,1686.42,535.46,1150.96,213035.25,30 Year
209,213035.25,1686.42,532.58,1153.84,211881.41,30 Year
210,211881.41,1686.42,529.7,1156.72,210724.69,30 Year
211,210724.69,1686.42,526.81,1159.61,209565.08,30 Year
212,209565.08,1686.42,523.91,1162.51,208402.57,30 Year
213,208402.57,1686.42,521.0,1165.42,207237.15,30 Year
214,207237.15,1686.42,518.09,1168.33,206068.82,30 Year
215,206068.82,1686.42,515.17,1171.25,204897.57,30 Year
216,204897.57,1686.42,512.24,1174.18,203723.39,30 Year
217,203723.39,1686.42,509.3,1177.12,202546.27,30 Year
218,202546.27,1686.42,506.36,1180.06,201366.21,30 Year
219,201366.21,1686.42,503.41,1183.01,200183.2,30 Year
220,200183.2,1686.42,500.45,1185.97,198997.23,30 Year
221,198997.23,1686.42,497.49,1188.93,197808.3,30 Year
222,197808.3,1686.42,494.52,1191.9,196616.4,30 Year
223,196616.4,1686.42,491.54,1194.88,195421.52,30 Year
224,195421.52,1686.42,488.55,1197.87,194223.65,30 Year
225,194223.65,1686.42,485.55,1200.87,193022.78,30 Year
226,193022.78,1686.42,482.55,1203.87,191818.91,30 Year
227,191818.91,1686.42,479.54,1206.88,190612.03,30 Year
228,190612.03,1686.42,476.53,1209.89,189402.14,30 Year
229,189402.14,1686.42,473.5,1212.92,188189.22,30 Year
230,188189.22,1686.42,470.47,1215.95,186973.27,30 Year
231,186973.27,1686.42,467.43,1218.99,185754.28,30 Year
232,185754.28,1686.42,464.38,1222.04,184532.24,30 Year
233,184532.24,1686.42,461.33,1225.09,183307.15,30 Year
234,183307.15,1686.42,458.26,1228.16,182078.99,30 Year
235,182078.99,1686.42,455.19,1231.23,180847.76,30 Year
236,180847.76,1686.42,452.11,1234.31,179613.45,30 Year
237,179613.45,1686.42,449.03,1237.39,178376.06,30 Year
238,178376.06,1686.42,445.94,1240.48,177135.58,30 Year
239,177135.58,1686.42,442.83,1243.59,175891.99,30 Year
240,175891.99,1686.42,439.72,1246.7,174645.29,30 Year
241,174645.29,1686.42,436.61,1249.81,173395.48,30 Year
242,173395.48,1686.42,433.48,1252.94,172142.54,30 Year
243,172142.54,1686.42,430.35,1256.07,170886.47,30 Year
244,170886.47,1686.42,427.21,1259.21,169627.26,30 Year
245,169627.26,1686.42,424.06,1262.36,168364.9,30 Year
246,168364.9,1686.42,420.91,1265.51,167099.39,30 Year
247,167099.39,1686.42,417.74,1268.68,165830.71,30 Year
248,165830.71,1686.42,414.57,1271.85,164558.86,30 Year
249,164558.86,1686.42,411.39,1275.03,163283.83,30 Year
250,163283.83,1686.42,408.2,1278.22,162005.61,30 Year
251,162005.61,1686.42,405.01,1281.41,160724.2,30 Year
252,160724.2,1686.42,401.81,1284.61,159439.59,30 Year
253,159439.59,1686.42,398.59,1287.83,158151.76,30 Year
254,158151.76,1686.42,395.37,1291.05,156860.71,30 Year
255,156860.71,1686.42,392.15,1294.27,155566.44,30 Year
256,155566.44,1686.42,388.91,1297.51,154268.93,30 Year
257,154268.93,1686.42,385.67,1300.75,152968.18,30 Year
258,152968.18,1686.42,382.42,1304.0,151664.18,30 Year
259,151664.18,1686.42,379.16,1307.26,150356.92,30 Year
260,150356.92,1686.42,375.89,1310.53,149046.39,30 Year
261,149046.39,1686.42,372.61,1313.81,147732.58,30 Year
262,147732.58,1686.42,369.33,1317.09,146415.49,30 Year
263,146415.49,1686.42,366.03,1320.39,145095.1,30 Year
264,145095.1,1686.42,362.73,1323.69,143771.41,30 Year
265,143771.41,1686.42,359.42,1327.0,142444.41,30 Year
266,142444.41,1686.42,356.11,1330.31,141114.1,30 Year
267,141114.1,1686.42,352.78,1333.64,139780.46,30 Year
268,139780.46,1686.42,349.45,1336.97,138443.49,30 Year
269,138443.49,1686.42,346.1,1340.32,137103.17,30 Year
270,137103.17,1686.42,342.75,1343.67,135759.5,30 Year
271,135759.5,1686.42,339.39,1347.03,134412.47,30 Year
272,134412.47,1686.42,336.03,1350.39,133062.08,30 Year
273,133062.08,1686.42,332.65,1353.77,131708.31,30 Year
274,131708.31,1686.42,329.27,1357.15,130351.16,30 Year
275,130351.16,1686.42,325.87,1360.55,128990.61,30 Year
276,128990.61,1686.42,322.47,1363.95,127626.66,30 Year
277,127626.66,1686.42,319.06,1367.36,126259.3,30 Year
278,126259.3,1686.42,315.64,1370.78,124888.52,30 Year
279,124888.52,1686.42,312.22,1374.2,123514.32,30 Year
280,123514.32,1686.42,308.78,1377.64,122136.68,30 Year
281,122136.68,1686.42,305.34,1381.08,120755.6,30 Year
282,120755.6,1686.42,301.88,1384.54,119371.06,30 Year
283,119371.06,1686.42,298.42,1388.0,117983.06,30 Year
284,117983.06,1686.42,294.95,1391.47,116591.59,30 Year
285,116591.59,1686.42,291.47,1394.95,115196.64,30 Year
286,115196.64,1686.42,287.99,1398.43,113798.21,30 Year
287,113798.21,1686.42,284.49,1401.93,112396.28,30 Year
288,112396.28,1686.42,280.99,1405.43,110990.85,30 Year
289,110990.85,1686.42,277.47,1408.95,109581.9,30 Year
290,109581.9,1686.42,273.95,1412.47,108169.43,30 Year
291,108169.43,1686.42,270.42,1416.0,106753.43,30 Year
292,106753.43,1686.42,266.88,1419.54,105333.89,30 Year
293,105333.89,1686.42,263.33,1423.09,103910.8,30 Year
294,103910.8,1686.42,259.77,1426.65,102484.15,30 Year
295,102484.15,1686.42,256.21,1430.21,101053.94,30 Year
296,101053.94,1686.42,252.63,1433.79,99620.15,30 Year
297,99620.15,1686.42,249.05,1437.37,98182.78,30 Year
298,98182.78,1686.42,245.45,1440.97,96741.81,30 Year
299,96741.81,1686.42,241.85,1444.57,95297.24,30 Year
300,95297.24,1686.42,238.24,1448.18,93849.06,30 Year
301,93849.06,1686.42,234.62,1451.8,92397.26,30 Year
302,92397.26,1686.42,230.99,1455.43,90941.83,30 Year
303,90941.83,1686.42,227.35,1459.07,89482.76,30 Year
304,89482.76,1686.42,223.7,1462.72,88020.04,30 Year
305,88020.04,1686.42,220.05,1466.37,86553.67,30 Year
306,86553.67,1686.42,216.38,1470.04,85083.63,30 Year
307,85083.63,1686.42,212.7,1473.72,83609.91,30 Year
308,83609.91,1686.42,209.02,1477.4,82132.51,30 Year
309,82132.51,1686.42,205.33,1481.09,80651.42,30 Year
310,80651.42,1686.42,201.62,1484.8,79166.62,30 Year
311,79166.62,1686.42,197.91,1488.51,77678.11,30 Year
312,77678.11,1686.42,194.19,1492.23,76185.88,30 Year
313,76185.88,1686.42,190.46,1495.96,74689.92,30 Year
314,74689.92,1686.42,186.72,1499.7,73190.22,30 Year
315,73190.22,1686.42,182.97,1503.45,71686.77,30 Year
316,71686.77,1686.42,179.21,1507.21,70179.56,30 Year
317,70179.56,1686.42,175.44,1510.98,68668.58,30 Year
318,68668.58,1686.42,171.67,1514.75,67153.83,30 Year
319,67153.83,1686.42,167.88,1518.54,65635.29,30 Year
320,65635.29,1686.42,164.08,1522.34,64112.95,30 Year
321,64112.95,1686.42,160.28,1526.14,62586.81,30 Year
322,62586.81,1686.42,156.46,1529.96,61056.85,30 Year
323,61056.85,1686.42,152.64,1533.78,59523.07,30 Year
324,59523.07,1686.42,148.8,1537.62,57985.45,30 Year
325,57985.45,1686.42,144.96,1541.46,56443.99,30 Year
326,56443.99,1686.42,141.1,1545.32,54898.67,30 Year
327,54898.67,1686.42,137.24,1549.18,53349.49,30 Year
328,53349.49,1686.42,133.37,1553.05,51796.44,30 Year
329,51796.44,1686.42,129.49,1556.93,50239.51,30 Year
330,50239.51,1686.42,125.59,1560.83,48678.68,30 Year
331,48678.68,1686.42,121.69,1564.73,47113.95,30 Year
332,47113.95,1686.42,117.78,1568.64,45545.31,30 Year
333,45545.31,1686.42,113.86,1572.56,43972.75,30 Year
334,43972.75,1686.42,109.93,1576.49,42396.26,30 Year
335,42396.26,1686.42,105.99,1580.43,40815.83,30 Year
336,40815.83,1686.42,102.03,1584.39,39231.44,30 Year
337,39231.44,1686.42,98.07,1588.35,37643.09,30 Year
338,37643.09,1686.42,94.1,1592.32,36050.77,30 Year
339,36050.77,1686.42,90.12,1596.3,34454.47,30 Year
340,34454.47,1686.42,86.13,1600.29,32854.18,30 Year
341,32854.18,1686.42,82.13,1604.29,31249.89,30 Year
342,31249.89,1686.42,78.12,1608.3,29641.59,30 Year
343,29641.59,1686.42,74.1,1612.32,28029.27,30 Year
344,28029.27,1686.42,70.07,1616.35,26412.92,30 Year
345,26412.92,1686.42,66.03,1620.39,24792.53,30 Year
346,24792.53,1686.42,61.98,1624.44,23168.09,30 Year
347,23168.09,1686.42,57.92,1628.5,21539.59,30 Year
348,21539.59,1686.42,53.84,1632.58,19907.01,30 Year
349,19907.01,1686.42,49.76,1636.66,18270.35,30 Year
350,18270.35,1686.42,45.67,1640.75,16629.6,30 Year
351,16629.6,1686.42,41.57,1644.85,14984.75,30 Year
352,14984.75,1686.42,37.46,1648.96,13335.79,30 Year
353,13335.79,1686.42,33.33,1653.09,11682.7,30 Year
354,11682.7,1686.42,29.2,1657.22,10025.48,30 Year
355,10025.48,1686.42,25.06,1661.36,8364.12,30 Year
356,8364.12,1686.42,20.91,1665.51,6698.61,30 Year
357,6698.61,1686.42,16.74,1669.68,5028.93,30 Year
358,5028.93,1686.42,12.57,1673.85,3355.08,30 Year
359,3355.08,1686.42,8.38,1678.04,1677.04,30 Year
360,1677.04,1686.42,4.19,1682.23,-5.19,30 Year
1,400000.0,2762.33,1000.0,1762.33,398237.67,15 Year
2,398237.67,2762.33,995.59,1766.74,396470.93,15 Year
3,396470.93,2762.33,991.17,1771.16,394699.77,15 Year
4,394699.77,2762.33,986.74,1775.59,392924.18,15 Year
5,392924.18,2762.33,982.31,1780.02,391144.16,15 Year
6,391144.16,2762.33,977.86,1784.47,389359.69,15 Year
7,389359.69,2762.33,973.39,1788.94,387570.75,15 Year
8,387570.75,2762.33,968.92,1793.41,385777.34,15 Year
9,385777.34,2762.33,964.44,1797.89,383979.45,15 Year
10,383979.45,2762.33,959.94,1802.39,382177.06,15 Year
11,382177.06,2762.33,955.44,1806.89,380370.17,15 Year
12,380370.17,2762.33,950.92,1811.41,378558.76,15 Year
13,378558.76,2762.33,946.39,1815.94,376742.82,15 Year
14,376742.82,2762.33,941.85,1820.48,374922.34,15 Year
15,374922.34,2762.33,937.3,1825.03,373097.31,15 Year
16,373097.31,2762.33,932.74,1829.59,371267.72,15 Year
17,371267.72,2762.33,928.16,1834.17,369433.55,15 Year
18,369433.55,2762.33,923.58,1838.75,367594.8,15 Year
19,367594.8,2762.33,918.98,1843.35,365751.45,15 Year
20,365751.45,2762.33,914.37,1847.96,363903.49,15 Year
21,363903.49,2762.33,909.75,1852.58,362050.91,15 Year
22,362050.91,2762.33,905.12,1857.21,360193.7,15 Year
23,360193.7,2762.33,900.48,1861.85,358331.85,15 Year
24,358331.85,2762.33,895.82,1866.51,356465.34,15 Year
25,356465.34,2762.33,891.16,1871.17,354594.17,15 Year
26,354594.17,2762.33,886.48,1875.85,352718.32,15 Year
27,352718.32,2762.33,881.79,1880.54,350837.78,15 Year
28,350837.78,2762.33,877.09,1885.24,348952.54,15 Year
29,348952.54,2762.33,872.38,1889.95,347062.59,15 Year
30,347062.59,2762.33,867.65,1894.68,345167.91,15 Year
31,345167.91,2762.33,862.91,1899.42,343268.49,15 Year
32,343268.49,2762.33,858.17,1904.16,341364.33,15 Year
33,341364.33,2762.33,853.41,1908.92,339455.41,15 Year
34,339455.41,2762.33,848.63,1913.7,337541.71,15 Year
35,337541.71,2762.33,843.85,1918.48,335623.23,15 Year
36,335623.23,2762.33,839.05,1923.28,333699.95,15 Year
37,333699.95,2762.33,834.24,1928.09,331771.86,15 Year
38,331771.86,2762.33,829.42,1932.91,329838.95,15 Year
39,329838.95,2762.33,824.59,1937.74,327901.21,15 Year
40,327901.21,2762.33,819.75,1942.58,325958.63,15 Year
41,325958.63,2762.33,814.89,1947.44,324011.19,15 Year
42,324011.19,2762.33,810.02,1952.31,322058.88,15 Year
43,322058.88,2762.33,805.14,1957.19,320101.69,15 Year
44,320101.69,2762.33,800.25,1962.08,318139.61,15 Year
45,318139.61,2762.33,795.34,1966.99,316172.62,15 Year
46,316172.62,2762.33,790.43,1971.9,314200.72,15 Year
47,314200.72,2762.33,785.5,1976.83,312223.89,15 Year
48,312223.89,2762.33,780.55,1981.78,310242.11,15 Year
49,310242.11,2762.33,775.6,1986.73,308255.38,15 Year
50,308255.38,2762.33,770.63,1991.7,306263.68,15 Year
51,306263.68,2762.33,765.65,1996.68,304267.0,15 Year
52,304267.0,2762.33,760.66,2001.67,302265.33,15 Year
53,302265.33,2762.33,755.66,2006.67,300258.66,15 Year
54,300258.66,2762.33,750.64,2011.69,298246.97,15 Year
55,298246.97,2762.33,745.61,2016.72,296230.25,15 Year
56,296230.25,2762.33,740.57,2021.76,294208.49,15 Year
57,294208.49,2762.33,735.52,2026.81,292181.68,15 Year
58,292181.68,2762.33,730.45,2031.88,290149.8,15 Year
59,290149.8,2762.33,725.37,2036.96,288112.84,15 Year
60,288112.84,2762.33,720.28,2042.05,286070.79,15 Year
61,286070.79,2762.33,715.17,2047.16,284023.63,15 Year
62,284023.63,2762.33,710.05,2052.28,281971.35,15 Year
63,281971.35,2762.33,704.92,2057.41,279913.94,15 Year
64,279913.94,2762.33,699.78,2062.55,277851.39,15 Year
65,277851.39,2762.33,694.62,2067.71,275783.68,15 Year
66,275783.68,2762.33,689.45,2072.88,273710.8,15 Year
67,273710.8,2762.33,684.27,2078.06,271632.74,15 Year
68,271632.74,2762.33,679.08,2083.25,269549.49,15 Year
69,269549.49,2762.33,673.87,2088.46,267461.03,15 Year
70,267461.03,2762.33,668.65,2093.68,265367.35,15 Year
71,265367.35,2762.33,663.41,2098.92,263268.43,15 Year
72,263268.43,2762.33,658.17,2104.16,261164.27,15 Year
73,261164.27,2762.33,652.91,2109.42,259054.85,15 Year
74,259054.85,2762.33,647.63,2114.7,256940.15,15 Year
75,256940.15,2762.33,642.35,2119.98,254820.17,15 Year
76,254820.17,2762.33,637.05,2125.28,252694.89,15 Year
77,252694.89,2762.33,631.73,2130.6,250564.29,15 Year
78,250564.29,2762.33,626.41,2135.92,248428.37,15 Year
79,248428.37,2762.33,621.07,2141.26,246287.11,15 Year
80,246287.11,2762.33,615.71,2146.62,244140.49,15 Year
81,244140.49,2762.33,610.35,2151.98,241988.51,15 Year
82,241988.51,2762.33,604.97,2157.36,239831.15,15 Year
83,239831.15,2762.33,599.57,2162.76,237668.39,15 Year
84,237668.39,2762.33,594.17,2168.16,235500.23,15 Year
85,235500.23,2762.33,588.75,2173.58,233326.65,15 Year
86,233326.65,2762.33,583.31,2179.02,231147.63,15 Year
87,231147.63,2762.33,577.86,2184.47,228963.16,15 Year
88,228963.16,2762.33,572.4,2189.93,226773.23,15 Year
89,226773.23,2762.33,566.93,2195.4,224577.83,15 Year
90,224577.83,2762.33,561.44,2200.89,222376.94,15 Year
91,222376.94,2762.33,555.94,2206.39,220170.55,15 Year
92,220170.55,2762.33,550.42,2211.91,217958.64,15 Year
93,217958.64,2762.33,544.89,2217.44,215741.2,15 Year
94,215741.2,2762.33,539.35,2222.98,213518.22,15 Year
95,213518.22,2762.33,533.79,2228.54,211289.68,15 Year
96,211289.68,2762.33,528.22,2234.11,209055.57,15 Year
97,209055.57,2762.33,522.63,2239.7,206815.87,15 Year
98,206815.87,2762.33,517.03,2245.3,204570.57,15 Year
99,204570.57,2762.33,511.42,2250.91,202319.66,15 Year
100,202319.66,2762.33,505.79,2256.54,200063.12,15 Year
101,200063.12,2762.33,500.15,2262.18,197800.94,15 Year
102,197800.94,2762.33,494.5,2267.83,195533.11,15 Year
103,195533.11,2762.33,488.83,2273.5,193259.61,15 Year
104,193259.61,2762.33,483.14,2279.19,190980.42,15 Year
105,190980.42,2762.33,477.45,2284.88,188695.54,15 Year
106,188695.54,2762.33,471.73,2290.6,186404.94,15 Year
107,186404.94,2762.33,466.01,2296.32,184108.62,15 Year
108,184108.62,2762.33,460.27,2302.06,181806.56,15 Year
109,181806.56,2762.33,454.51,2307.82,179498.74,15 Year
110,179498.74,2762.33,448.74,2313.59,177185.15,15 Year
111,177185.15,2762.33,442.96,2319.37,174865.78,15 Year
112,174865.78,2762.33,437.16,2325.17,172540.61,15 Year
113,172540.61,2762.33,431.35,2330.98,170209.63,15 Year
114,170209.63,2762.33,425.52,2336.81,167872.82,15 Year
115,167872.82,2762.33,419.68,2342.65,165530.17,15 Year
116,165530.17,2762.33,413.82,2348.51,163181.66,15 Year
117,163181.66,2762.33,407.95,2354.38,160827.28,15 Year
118,160827.28,2762.33,402.06,2360.27,158467.01,15 Year
119,158467.01,2762.33,396.16,2366.17,156100.84,15 Year
120,156100.84,2762.33,390.25,2372.08,153728.76,15 Year
121,153728.76,2762.33,384.32,2378.01,151350.75,15 Year
122,151350.75,2762.33,378.37,2383.96,148966.79,15 Year
123,148966.79,2762.33,372.41,2389.92,146576.87,15 Year
124,146576.87,2762.33,366.44,2395.89,144180.98,15 Year
125,144180.98,2762.33,360.45,2401.88,141779.1,15 Year
126,141779.1,2762.33,354.44,2407.89,139371.21,15 Year
127,139371.21,2762.33,348.42,2413.91,136957.3,15 Year
128,136957.3,2762.33,342.39,2419.94,134537.36,15 Year
129,134537.36,2762.33,336.34,2425.99,132111.37,15 Year
130,132111.37,2762.33,330.27,2432.06,129679.31,15 Year
131,129679.31,2762.33,324.19,2438.14,127241.17,15 Year
132,127241.17,2762.33,318.1,2444.23,124796.94,15 Year
133,124796.94,2762.33,311.99,2450.34,122346.6,15 Year
134,122346.6,2762.33,305.86,2456.47,119890.13,15 Year
135,119890.13,2762.33,299.72,2462.61,117427.52,15 Year
136,117427.52,2762.33,293.56,2468.77,114958.75,15 Year
137,114958.75,2762.33,287.39,2474.94,112483.81,15 Year
138,112483.81,2762.33,281.2,2481.13,110002.68,15 Year
139,110002.68,2762.33,275.0,2487.33,107515.35,15 Year
140,107515.35,2762.33,268.78,2493.55,105021.8,15 Year
141,105021.8,2762.33,262.55,2499.78,102522.02,15 Year
142,102522.02,2762.33,256.3,2506.03,100015.99,15 Year
143,100015.99,2762.33,250.03,2512.3,97503.69,15 Year
144,97503.69,2762.33,243.75,2518.58,94985.11,15 Year
145,94985.11,2762.33,237.46,2524.87,92460.24,15 Year
146,92460.24,2762.33,231.15,2531.18,89929.06,15 Year
147,89929.06,2762.33,224.82,2537.51,87391.55,15 Year
148,87391.55,2762.33,218.47,2543.86,84847.69,15 Year
149,84847.69,2762.33,212.11,2550.22,82297.47,15 Year
150,82297.47,2762.33,205.74,2556.59,79740.88,15 Year
151,79740.88,2762.33,199.35,2562.98,77177.9,15 Year
152,77177.9,2762.33,192.94,2569.39,74608.51,15 Year
153,74608.51,2762.33,186.52,2575.81,72032.7,15 Year
154,72032.7,2762.33,180.08,2582.25,69450.45,15 Year
155,69450.45,2762.33,173.62,2588.71,66861.74,15 Year
156,66861.74,2762.33,167.15,2595.18,64266.56,15 Year
157,64266.56,2762.33,160.66,2601.67,61664.89,15 Year
158,61664.89,2762.33,154.16,2608.17,59056.72,15 Year
159,59056.72,2762.33,147.64,2614.69,56442.03,15 Year
160,56442.03,2762.33,141.1,2621.23,53820.8,15 Year
161,53820.8,2762.33,134.55,2627.78,51193.02,15 Year
162,51193.02,2762.33,127.98,2634.35,48558.67,15 Year
163,48558.67,2762.33,121.39,2640.94,45917.73,15 Year
164,45917.73,2762.33,114.79,2647.54,43270.19,15 Year
165,43270.19,2762.33,108.17,2654.16,40616.03,15 Year
166,40616.03,2762.33,101.54,2660.79,37955.24,15 Year
167,37955.24,2762.33,94.88,2667.45,35287.79,15 Year
168,35287.79,2762.33,88.21,2674.12,32613.67,15 Year
169,32613.67,2762.33,81.53,2680.8,29932.87,15 Year
170,29932.87,2762.33,74.83,2687.5,27245.37,15 Year
171,27245.37,2762.33,68.11,2694.22,24551.15,15 Year
172,24551.15,2762.33,61.37,2700.96,21850.19,15 Year
173,21850.19,2762.33,54.62,2707.71,19142.48,15 Year
174,19142.48,2762.33,47.85,2714.48,16428.0,15 Year
175,16428.0,2762.33,41.07,2721.26,13706.74,15 Year
176,13706.74,2762.33,34.26,2728.07,10978.67,15 Year
177,10978.67,2762.33,27.44,2734.89,8243.78,15 Year
178,8243.78,2762.33,20.6,2741.73,5502.05,15 Year
179,5502.05,2762.33,13.75,2748.58,2753.47,15 Year
180,2753.47,2762.33,6.88,2755.45,-1.98,15 Year
